-                
-                
-               p
-  ---ttttttttt--
-  --------------
-               -
-               -
-------tt-----  -
-  -----------  -
-               -
-----------------
